###########
#  X      #
#       P #
#  P      #
#    O    #
###########