#################
#O        P     #
#    X          # 
#               # 
#################