###########
#  X      #
#       P #
#  X      #
#    O    #
###########