###########
#         #
#       P #
#         #
#         #
###########