###########
#         #
#     X P #
#         #
#         #
###########