###########
#         #
#       P #
#         #
#    O    #
###########