###########
#  X      #
#       P #
#  O      #
#    O    #
###########