############
#    T   O #
# Pp    ####
#          #
#######    #  #####
#   T #    ####   #
#O t ##        tX #
#####      #####  #
#       XX #   ####
#  O    #  #
############
