#################
#O        P     #
#    X p        # 
#               # 
#################