############
#        O #
# Pp    ####
#          #
#######    #  #####
# O  ##    ####   #
#    ##         X #
#          #####  #
#       XX #   ####
#  O    #  #
############
